
SO ./texture/wall.xpm

WE ./texture/floor.xpm




EA ./texture/exit.xpm





NO ./texture/player.xpm






F 220,100,0




C 225,30,0

        1111111111 11111111111111
        1E00000001110000000000001
        1011000001110000000000001
        1001000000000000000000001
111111111011000001110000000000001
100000000011000001110111111111111
11110111111111011100000010001
11110111111111011101010010001
11000000110101011100000000001
10000000000000001100000010001
10000000000000001101010010001
11000001110101011100011110001
11110111 1110101 101111000001
11110111 1111111 111111111111
11110111111111111111111111111

10000000000000001111111111111
11111111101111111111111111111
11111111101111111111111111111
100000000000000000000000000001
100000000000000000000000010001
11111111111111111111111111111


